Classic Cheeseburger : [Burger] : [N] : [4.0] : [Beef, American cheese, Lettuce, Tomato, Onion, Pickles, Ketchup, Mustard, Mayonnaise]
Bacon Cheeseburger : [Burger] : [N] : [5.0] : [Beef, Bacon, American cheese, Lettuce, Tomato, Onion, Pickles, Ketchup, Mustard, Mayonnaise]
Mushroom Swiss Burger : [Burger] : [N] : [5.5] : [Beef, Swiss cheese, Mushrooms, Onion, Lettuce, Tomato, Ketchup, Mustard, Mayonnaise]
BBQ Burger : [Burger] : [N] : [5.5] : [Beef, BBQ sauce, Cheddar cheese, Onion, Lettuce, Tomato, Pickles]
Hawaiian Burger : [Burger] : [N] : [6.5] : [Beef, Pineapple, Swiss cheese, Bacon, Lettuce, Tomato, Teriyaki sauce]
Veggie Burger : [Burger] : [V] : [5.5] : [Vegetable patty, Lettuce, Tomato, Onion, Avocado, Veggie cheese, Pickles, Ketchup, Mustard, Mayonnaise]
Guacamole Burger : [Burger] : [N] : [6.5] : [Beef, Guacamole, American cheese, Lettuce, Tomato, Onion, Pickles, Ketchup, Mustard, Mayonnaise]
Jalapeno Burger : [Burger] : [N] : [5.5] : [Beef, Jalapenos, Pepper jack cheese, Lettuce, Tomato, Onion, Pickles, Ketchup, Mustard, Mayonnaise]
Blue Cheese Burger : [Burger] : [N] : [6.5] : [Beef, Blue cheese, Caramelized onions, Lettuce, Tomato, Pickles, Ketchup, Mustard, Mayonnaise]
Buffalo Chicken Burger : [Burger] : [N] : [5.5] : [Chicken, Buffalo sauce, Blue cheese, Lettuce, Tomato, Onion, Pickles]
Teriyaki Burger : [Burger] : [N] : [6.5] : [Beef, Teriyaki sauce, Pineapple, Swiss cheese, Lettuce, Tomato, Onion, Pickles]
Mediterranean Lamb Burger : [Burger] : [N] : [7.5] : [Lamb, Feta cheese, Tzatziki sauce, Lettuce, Tomato, Onion, Cucumber]
Portobello Mushroom Burger : [Burger] : [V] : [6.5] : [Portobello mushrooms, Swiss cheese, Caramelized onions, Lettuce, Tomato, Balsamic glaze]
Black Bean Burger : [Burger] : [V] : [5.5] : [Black bean patty, Lettuce, Tomato, Onion, Avocado, Cheese, Pickles, Ketchup, Mustard, Mayonnaise]
Turkey Burger : [Burger] : [N] : [5.0] : [Turkey, Lettuce, Tomato, Onion, Pickles, Ketchup, Mustard, Mayonnaise]
Caprese Burger : [Burger] : [N] : [6.5] : [Beef, Mozzarella cheese, Tomato, Basil, Balsamic glaze, Lettuce]
Greek Burger : [Burger] : [N] : [6.5] : [Beef, Feta cheese, Olives, Tzatziki sauce, Lettuce, Tomato, Onion]
Spicy Sriracha Burger : [Burger] : [N] : [5.5] : [Beef, Pepper jack cheese, Jalapenos, Lettuce, Tomato, Onion, Sriracha mayo]
Philly Cheesesteak Burger : [Burger] : [N] : [6.5] : [Beef, Provolone cheese, Sauteed peppers, Onion Lettuce, Tomato, Ketchup, Mustard, Mayonnaise]
Caprese Chicken Burger : [Burger] : [N] : [6.5] : [Chicken, Mozzarella cheese, Tomato, Basil, Balsamic glaze, Lettuce, Mayonnaise]
Southwest Burger : [Burger] : [N] : [6.5] : [Beef, Pepper jack cheese, Avocado, Jalapenos, Lettuce, Tomato, Red onion, Chipotle mayo]
Pesto Turkey Burger : [Burger] : [N] : [6.5] : [Turkey, Mozzarella cheese, Pesto sauce, Sun-dried tomatoes, Lettuce, Tomato, Red onion, Garlic aioli]
French Onion Burger : [Burger] : [N] : [6.5] : [Beef, Gruyere cheese, Caramelized onions, Lettuce, Tomato, Dijon mustard, Garlic aioli]
Korean BBQ Burger : [Burger] : [N] : [7.5] : [Beef, Kimchi, Gochujang sauce, Sesame seeds, Lettuce, Tomato, Red onion, Sriracha mayo]
Smoky Chipotle Black Bean Burger : [Burger] : [V] : [5.5] : [Black bean patty, Pepper jack cheese, Chipotle peppers, Lettuce, Tomato, Red onion, Avocado, Chipotle mayo]
Margherita Pizza : [Pizza] : [V] : [10.0] : [Mozzarella cheese, Tomato sauce, Basil]
Pepperoni Pizza : [Pizza] : [N] : [12.0] : [Mozzarella cheese, Pepperoni, Tomato sauce]
Hawaiian Pizza : [Pizza] : [N] : [12.5] : [Mozzarella cheese, Ham, Pineapple, Tomato sauce]
Supreme Pizza : [Pizza] : [N] : [15.0] : [Mozzarella cheese, Pepperoni, Sausage, Bell peppers, Onions, Mushrooms, Olives, Tomato sauce]
BBQ Chicken Pizza : [Pizza] : [N] : [14.5] : [Mozzarella cheese, Chicken, BBQ sauce, Red onion, Cilantro]
Margherita with Prosciutto : [Pizza] : [N] : [14.0] : [Mozzarella cheese, Tomato sauce, Basil, Prosciutto]
Four Cheese Pizza : [Pizza] : [V] : [13.5] : [Mozzarella cheese, Cheddar cheese, Parmesan cheese, Gorgonzola cheese, Tomato sauce]
Veggie Supreme Pizza : [Pizza] : [V] : [12.5] : [Mozzarella cheese, Bell peppers, Onions, Mushrooms, Olives, Tomato sauce]
Meat Lover's Pizza : [Pizza] : [N] : [15.5] : [Mozzarella cheese, Pepperoni, Sausage, Bacon, Ham, Tomato sauce]
Spinach and Feta Pizza : [Pizza] : [V] : [13.0] : [Mozzarella cheese, Spinach, Feta cheese, Tomato sauce]
Buffalo Chicken Pizza : [Pizza] : [N] : [14.5] : [Mozzarella cheese, Chicken, Buffalo sauce, Ranch dressing, Red onion]
White Pizza : [Pizza] : [V] : [13.0] : [Mozzarella cheese, Ricotta cheese, Garlic, Olive oil, Basil]
Pesto Chicken Pizza : [Pizza] : [N] : [14.5] : [Mozzarella cheese, Chicken, Pesto sauce, Sun-dried tomatoes]
Margherita with Arugula : [Pizza] : [V] : [14.0] : [Mozzarella cheese, Tomato sauce, Basil, Arugula, Balsamic glaze]
Mediterranean Pizza : [Pizza] : [V] : [14.5] : [Mozzarella cheese, Olives, Sun-dried tomatoes, Feta cheese, Red onion, Tomato sauce]
BBQ Bacon Cheeseburger Pizza : [Pizza] : [N] : [15.5] : [Mozzarella cheese, Beef, Bacon, Cheddar cheese, BBQ sauce, Tomato sauce]
Chicken Alfredo Pizza : [Pizza] : [N] : [14.5] : [Mozzarella cheese, Chicken, Alfredo sauce, Broccoli]
Caprese Pizza : [Pizza] : [V] : [13.0] : [Mozzarella cheese, Tomato, Basil, Balsamic glaze]
Margherita with Provolone : [Pizza] : [V] : [11.5] : [Provolone cheese, Tomato sauce, Basil]
Philly Cheesesteak Pizza : [Pizza] : [N] : [16.0] : [Mozzarella cheese, Beef, Bell peppers, Onions, Provolone cheese, Tomato sauce]
Chicken Bacon Ranch Pizza : [Pizza] : [N] : [15.5] : [Mozzarella cheese, Chicken, Bacon, Ranch dressing, Tomato sauce]
Mediterranean Veggie Pizza : [Pizza] : [V] : [14.5] : [Mozzarella cheese, Artichoke hearts, Sun-dried tomatoes, Spinach leaves, Red onion, Feta cheese, Tomato sauce]
Taco Pizza : [Pizza] : [N] : [15.0] : [Mozzarella cheese, Beef, Taco seasoning, Tomato sauce, Lettuce, Tomato, Cheddar cheese, Sour cream]
Bacon Egg Breakfast Pizza : [Pizza] : [N] : [13.5] : [Mozzarella cheese, Bacon, Eggs, Cheddar cheese, Tomato sauce]
Buffalo Cauliflower Pizza : [Pizza] : [N] : [14.5] : [Mozzarella cheese, Cauliflower, Red onion, Ranch dressing, Tomato sauce]
Pad Thai : [Wok] : [N] : [10.5] : [Rice noodles, Tofu, Shrimp, Bean sprouts, Scallops, Eggs, Peanuts, Pad Thai sauce]
Chow Mein : [Wok] : [N] : [11.0] : [Egg noodles, Chicken, Shrimp, Carrots, Celery, Cabbage, Soy sauce]
Singapore Noodles : [Wok] : [N] : [11.5] : [Rice noodles, Shrimp, Chicken, Curry powder, Bean sprouts, Scallops, Bell peppers]
Garlic Noodles : [Wok] : [V] : [9.5] : [Egg noodles, Garlic, Butter, Soy sauce, Green onions]
Beef Lo Mein : [Wok] : [N] : [12.0] : [Egg noodles, Beef, Broccoli, Carrots, Bell peppers, Soy sauce]
Vegetable Stir-Fry Noodles : [Wok] : [V] : [10.0] : [Egg noodles, Carrots, Cabbage, Bell peppers, Broccoli, Soy sauce]
Pad See Ew : [Wok] : [N] : [11.5] : [Wide rice noodles, Chicken, Broccoli, Eggs, Soy sauce, Oyster sauce]
Drunken Noodles (Pad Kee Mao) : [Wok] : [N] : [11.5] : [Wide rice noodles, Chicken, Basil, Bell peppers, Onions, Garlic, Soy sauce]
Teriyaki Noodles : [Wok] : [N] : [10.5] : [Soba noodles, Chicken, Broccoli, Carrots, Teriyaki sauce]
Spicy Garlic Shrimp Noodles : [Wok] : [N] : [12.5] : [Ramen noodles, Shrimp, Garlic, Chili flakes, Soy sauce, Sesame oil]
Sesame Noodles : [Wok] : [V] : [9.0] : [Egg noodles, Peanut butter, Sesame oil, Soy sauce, Green onions]
Thai Peanut Noodles : [Wok] : [N] : [10.5] : [Rice noodles, Chicken, Peanut butter, Soy sauce, Lime juice, Cilantro]
Beef Chow Fun : [Wok] : [N] : [12.5] : [Wide rice noodles, Beef, Bean sprouts, Scallops, Soy sauce]
Kung Pao Noodles : [Wok] : [N] : [11.0] : [Udon noodles, Chicken, Peanuts, Bell peppers, Zucchini, Soy sauce, Kung Pao sauce]
Black Bean Noodles : [Wok] : [N] : [10.5] : [Egg noodles, Chicken, Black bean sauce, Carrots, Bell peppers, Mushrooms]
Thai Basil Chicken Noodles : [Wok] : [N] : [11.5] : [Rice noodles, Chicken, Basil, Bell peppers, Onions, Soy sauce]
Sweet and Sour Noodles : [Wok] : [N] : [10.0] : [Egg noodles, Chicken, Pineapple, Bell peppers, Onions, Sweet sauce, Sour sauce]
Dan Dan Noodles : [Wok] : [N] : [10.5] : [Soba noodles, Pork, Sesame paste, Soy sauce, Garlic, Green onions, Chili oil]
Shrimp Stir-Fry Noodles : [Wok] : [N] : [12.0] : [Egg noodles, Shrimp, Carrots, Bell peppers, Broccoli, Soy sauce]
Sesame Ginger Noodles : [Wok] : [V] : [10.0] : [Ramen noodles, Ginger, Sesame oil, Soy sauce, Green onions]
Pad Woonsen : [Wok] : [N] : [11.0] : [Glass noodles, Chicken, Shrimp, Carrots, Cabbage, Bell peppers, Mushrooms, Soy sauce]
Chicken Cashew Noodles : [Wok] : [N] : [11.5] : [Rice noodles, Chicken, Cashews, Carrots, Bell peppers, Broccoli, Soy sauce]
Garlic Ginger Beef Noodles : [Wok] : [N] : [12.0] : [Udon noodles, Beef, Garlic, Ginger, Soy sauce, Green onions]
Vietnamese Rice Noodles with Lemongrass Chicken : [Wok] : [N] : [12.5] : [Rice noodles, Lemongrass, Chicken, Cucumber, Carrots, Lettuce, Fish sauce]
Peanut Sesame Noodles : [Wok] : [V] : [10.5] : [Soba noodles, Peanut butter, Sesame oil, Soy sauce, Green onions]
California Roll : [Roll] : [N] : [8.5] : [Imitation crab meat, Cucumber, Avocado]
Spicy Tuna Roll : [Roll] : [N] : [9.0] : [Tuna, Spicy mayo]
Dragon Roll : [Roll] : [N] : [12.0] : [Eel, Avocado, Cucumber, Eel sauce]
Rainbow Roll : [Roll] : [N] : [11.5] : [Tuna, Salmon, Yellowtail, Avocado]
Philadelphia Roll : [Roll] : [N] : [10.0] : [Smoked salmon, Cream cheese, Cucumber]
Shrimp Tempura Roll : [Roll] : [N] : [10.5] : [Shrimp, Tempura flakes, Avocado, Cucumber]
Spider Roll : [Roll] : [N] : [12.5] : [Crab, Avocado, Cucumber, Spicy mayo]
Volcano Roll : [Roll] : [N] : [11.0] : [Crab, Shrimp, Scallops, Spicy mayo, Eel sauce]
Caterpillar Roll : [Roll] : [N] : [11.5] : [Avocado, Eel, Eel sauce]
Crunchy Roll : [Roll] : [V] : [9.5] : [Tempura flakes, Spicy mayo, Cucumber]
Alaska Roll : [Roll] : [N] : [10.5] : [Smoked salmon, Avocado, Cucumber]
Crunchy Spicy Salmon Roll : [Roll] : [N] : [10.5] : [Salmon, Spicy mayo, Tempura flakes]
Salmon Avocado Roll : [Roll] : [N] : [10.0] : [Salmon, Avocado]
Yellowtail Roll : [Roll] : [N] : [10.5] : [Yellowtail fish, Scallops]
Tuna Avocado Roll : [Roll] : [N] : [11.0] : [Tuna, Avocado]
Cucumber Roll : [Roll] : [V] : [7.5] : [Cucumber]
Salmon Roll : [Roll] : [N] : [9.0] : [Salmon]
Vegetable Roll : [Roll] : [V] : [8.0] : [Carrot, Cucumber, Avocado]
Avocado Roll : [Roll] : [V] : [8.0] : [Avocado]
Lobster Roll : [Roll] : [N] : [14.0] : [Lobster, Avocado, Cucumber, Spicy mayo]
Scallop Roll : [Roll] : [N] : [12.5] : [Scallops, Spicy mayo]
Tofu Roll : [Roll] : [V] : [8.0] : [Tofu, Avocado, Cucumber]
Tempura Asparagus Roll : [Roll] : [V] : [9.5] : [Asparagus, Tempura flakes, Avocado, Spicy mayo]
Eel Cucumber Roll : [Roll] : [N] : [11.0] : [Eel, Cucumber, Eel sauce]
Green Dragon Roll : [Roll] : [N] : [12.5] : [Shrimp, Tempura flakes, Avocado, Cucumber, Eel sauce]_